<oomap
>0000000000000000000000000000000000000000000000000000
>0000000000000000000000000000011111111111111110000000
>0000011111111100000000000011111111111111111111000000
>0000111111111000000000000000001111111111111111000000
>0000001111111000000000000000111111111111111111110000
>0000011111110000000000000000011111111111111111100000
>0000001111111000000000000011111111111111111111000000
>0000000011111000000000000000001111111111111000000000
>0000000001111111000000000000000001111111000000000000
>0000001111111100000000000000000000011111110000000000
>0000001011110000000000000000000000001111111000000000
>0000000000000000000000000000000000011111100000000000
>0000000000000000000000000000000000000000000000000000
>0000000000000000000000000000000000000000000000000000
>0000000000000000000000000000000000000000000000000000
>0000000000000000000000000000000000000000000000000000
>0000000000000000000000000000000000000000000000000000
>0000000000000000000000111111111100000000000000000000
>0000000000000000000011111111111111100000000000000000
>0000000011111111111111111000011111111111111110000000
>0000011111111111111111100011111111111111111111000000
>0000111111111111111100000000001111111111111111000000
>0000001111111000000000000000111111111111111111110000
>0000011111111111110000000000011111111111111111100000
>0000001111111111111000000011111111111111111111000000
>0000000011111000000000000000001111111111111000000000
>0000000001111111111100000000000001111111000000000000
>0000001111111111111111100000000000011111110000000000
>0000001011111111111100000000000000001111111000000000
>0000000000000000000000000000000000011111100000000000
end